R 1080 640
NO  ./text/1234.xpm
SO  ./text/1234.xpm
EA  ./text/red_brick.xpm
WE  ./text/red_brick.xpm
S   ./text/barrel.xpm
C 189,214,252
F 209,161,161

        1111111111111111111111111
        1000000001110000000000001
        1110000011100000020020001
        1001000000000000000000001
111111111011000001110000000000001
100000000011000001110111100001111
111101111111110111000000010000111
11110111111111011101010010000111
1100000011010101110000001000011
10000000200000001100000010000111
10000000000000001101000011000111
110000011101010111110111100N0011
11110111011101010101111010000111
11111111111111111111111110011111
111111111111111111111111111111111